 ****************************************************************************************************
      *       * *         *             *         *           *     *     *     *     *     *   *   *
* *** * ***** * * ******* ******* ******* *** ***** ********* * *** * *** * *** * *** * *** * *** * *
* *   *     * *   *     * *     *   *     *         *     *   * *   * *     *   *   *     *     * * *
* *** ******* ***** ***** * *** *** * ***** * ******* *** * *** * *** * ***** ***** *********** * * *
*   *       *     *       *   *   * *     * * *   * * * * *   * *   * *   *   *     *     *     * * *
*** ******* *** ******* ***** *** * ***** * * *** * * * * *** ***** * *** ********* ***** * ***** * *
*   *       * * *     *   *     *   *     * *     *   *     *       *   *   * *     *   * * *   * * *
* *** ******* * * *** *** * * * ***** ***** ******* *********** *********** * * ***** * * * *** * * *
*   *   *   *   *   * * * * * *       *   *       *   *       * *   *         *   *   *   *       * *
* * *** * * *** * * * * * * *** *** ***** * ***** *** * ***** * * * * ***** ***** * * ********* *** *
* *   *   *   * * * *   * * *   *   *   * *   *     * * *   *     * * *   *   *   * * *           * *
* *********** * *** * *** * * *** *** * * ***** ***** * * * *** *** * * * ***** *** *** ***** ***** *
* *     *   *     * *   * * * *   *   * *       *       * *   * * *   * * *   * *   *   * *   *     *
* * *** * * ***** * * * * * * * * * *** *** ***** *** *** * * * * ***** * * * * * *** *** * *** *****
* *   *   *   *   * * *   * * * *   *   * * *   * *   *   * * *     * * * * *   * *   * *   * * *   *
* *********** * ***** ******* ******* *** * * * * * ********* *** * * * * * * *** *** * * *** * * ***
*       *   *   *     *       *   *   *     * * * * *   *   *   * *   * * * * * *     *   *   * *   *
***** * * * *** * ***** ******* * * *** ***** *** * * * * * *** * *** * * * * * * * ******* *** *** *
*     *   *   *         *       *     *     *     *   *   *     *   *   *   *   * *           *     $
*****************************************************************************************************